25 20
#############
#...........#    ########
#.......s...######......#
#...s...................#
#...........######......#
#.....s.....#    #......#
#...........#    #......#
#...........#    #.....k#
#####..######    ###..###
    #..#           #..#
    #..#           #..#
    #..#          ##..##
  ###..####      #......#
  #..@....#      #......#
  #.......#      #.....w#
  #...../.#      #......#
  #.......#      #......#
  #.......#      #......#
  #.......#      #..g...#
  #########       ######
