25 21
#############
#...........#    ########
#..s........######g.....#
#...s.......d...........#
#...........######......#
#.....s.....#    #......#
#...........#    #......#
#........k..#    #......#
####...######    ###..###
    #.#            #..#
    #.#            #..#
   #...#          ##..##
  #.....#        #......#
  #.@...#        #...a..#
  #.....#        #......#
   #...#         #.....w#
    #8#          #......#
   #...#         #..g...#
   #./.#          ######
   #...#
    ###